
//system
btnStart = 新的游戏
btnYes = 好的
btnNo = 不要
btnLoadStart = 加载游戏
btnContinue = 继续游戏
newGameTip = 开始新游戏么?\n所有未保存的进度都会被重置。

btnClose = 关闭
btnCombine = 合成
btnUse  = 使用
multiselected = 你选择了两个物品，尝试合成么？

btnResume = 继续游戏
btnExit = 返回主页
gamePaused = 游戏暂停
btnJournal = 日志
btnSave = 保存
btnLoad = 加载
btnTake = 拿走
btnCancel = 取消

overwrite = 覆盖这个存档？
loadthis = 读取这个存档？
continueGame = 继续上次进度？

titleSave = 保存游戏
titleLoad = 加载游戏

//item
remoteEmpty = 一个空空的遥控器。
key1 = 照片边上拿到的钥匙
key2 = 拼图后从画像里掉下来的钥匙
battery2 = 一节普通的电池
battery1 = 一节普通的电池
batteryGroup = 一个电池组
remote = 装了电池的遥控器

//dialog
annatalk0 = 我是安娜，这是我的家;请拖动屏幕空白处，然后拿起左边的电池
annatalk2 = 你已经拿好这里的电池了

//game
requirekey = 你需要一个合适的钥匙去开锁。
unlockColset1 = 打开了抽屉的锁。
mainDoorLockTip = 我必须先找到一个密码，否则根本不可能打开它.
youwinTip = 你赢了！
shutedcloset = 你需要一把合适的钥匙。
garageLocked = 外面的车库锁住了，我又出不去，但一定有什么办法打开它。
finishedJigsaw = 已经完成了，不需要再动它了吧。

//journal
j_intro_name1 = 介绍日志一
j_intro_desc1 = 嗨亲爱的，这是一个日志功能演示，你可以通过它们留下游戏线索或者描述故事背景。每个日志可以添加一个图标和一个插图。这个日志是可以拿起来的。拿起来以后就能在日志里随时查看。
j_intro_name2 = 介绍日志二
j_intro_desc2 = 这是另外一篇日志演示，所不同的是，它不能被玩家拿起。所以可以用来让玩家反复跑来查看的一种线索。
